@^.^~****^*~~.~^~..~~~^~.^~.*~**.^^*^*^~..*^^..~^.
*#*~*.~^^^~~.*~*.**.~~^*^**.^~*^^.*^...^..^.**.~^*
^^#**~.*^*^..^**.~~~.~*.~^^~^~^.^~^*~**.~*^.^**.*.
*~~#~^.~*~^~^^*^**.~.*^^*~~^^*~.^.*^^*^.^.~~^^^*~.
*.^~#^.~^.^.^^*~^~~*^..^~^~~^.*^^..**.**~.~~^~*~**
^.^^~#.*~**.*~*^*~^*~~^.^.~.~^**~.^^^^*.~.~~~^^.^.
*~~.*#^~~~^*.^*~~~*^.^**^*^.^.^~~***^^*^.~^^.^^.~.
.~.*~~#*.**.~^^~**^.^.^~~~^.~.^~~^^.~^^.^^~.~.~.*^
.^^^~~#~.^.~.*~.~~..~*~^.~**~..^****~.*~^~~*~**^~^
^^^*^^*#...*.^^*^^^.*~*~^^~*~~.~****~~~~***.^^~~^~
..*^^^^^#^~.^~.^.^^~*~^*~**^*^.~~~*^.^^~**~*~.....
**.^~~~^~#~****.**^~.^.*^^^~.^...~.**^^^^~^.~^~.~*
^*~.*.~*^#~.^^^^^*~.**~^.*^*.~~..^~~~*~*^.~~^*^*^^
~*^.^..**~###*^~***^~~*^*.*~..~^^***^.*~.^*^^^^.~.
*~^~^**^^*##~#*~^^*~~~*^*~~~~*~^^^*~..~~~~~.*~^~*.
^.*.^*^**^#^~*#.*.~^~~~^..~~~*~~^*~..^^.^~*.^~^~**
.***^..*^~~~~^~#*^~~.*.~^.^^*.***^~^.*....~.^.*~^^
^^~~~~.**.*.^^*#^~~^....*~*^~*^^.^~~~^*.~^^^~**^~~
^~~*^*.~.*^^^*^.##.~*...~**^.^^~.^^.^..^.^**.^^..*
~^***~^.~.~^^^*~~~#*..^~^^.~^.~.**...~^~**~^~~**^~
~~~^~.^*.^*.~*.*~~^#.~*^^~~**.*.*.~^^^..^.~^.*.^~~
^^~...^.*~.^^**~^~*.#^~^~*....^.^^**~.*.^^*..~*~.*
^..^...~.~.*.~***~*~~#..~*~^^~~^~**^~~^*^^~*.~*^*^
*^.**^~*****.~~~..~^~.#.^*~^.^^*^..*~^.^.^*.^.~^^*
~...~*^....*^.*^^*...^#~~..^.*~.*~.*^.^*^*^.****^~
^..~***^.*^~~.****.~*^#~.^~*.~^*^~^.****~..~*..*^~
.~^~**~^^..~~~^..*~*.^*#~..^^*.~.*..*~~*~.^~.~*~~.
.***~..~**^.~.~.~*.~~**.#^.^~..~*~~~~*.**~~^..^.^^
~.*.~^*^*~^.~*..*~^~~.*.*#.*.*..^~.*~^^*.~^.^~^**^
.*^~^^*.^*.~*...*~~~*.**.~#..*.*^.^*.^*~*.^~^**^*.
.~..*....~..~.***~..~^..~~^#^*^~^^~~**^.*~**^**^^*
^.*.~.^.**^*^.~^^*.~..*^~*^*##.~**..^.~~*..^*^~*.~
^~~^~~*.~^^~~^**.^.^^^*^.*^^~~#^#*~^*^^..**..**..^
^.^*.*^..*.~~.^^***^.*~..~.**^*#~#...^^~*.~^~^..~~
~^^.^..*^^.**.~~^*~*^~*~^~~.~*.^~#~*^~*.*..^.^^*^*
^^.~*^~~*.~~*~.^..~*.^.~**.^*^.^~.#*.~*.~...~~..*.
.~..^.~.~.^*.~^*~.~.*^*~~*.^.*****#~*~~*^~~~^.~~*~
~.*..^^*^~*.~~.~.^~..~.~^^^.*~*.**~#*~*^*^^~..^~^^
*.^*^**^*.^^*....**..~^^~.^*^.*~*^**##.#*.^^*^^^.~
^*^~^^*.~*~^*~^~~.*.^*^~*^^~.*~.*~.*###~#~~.~*^~~*
~~**~*.^.*~..~~^^^~^^^.~***^*.^*~^*~#~#~*##..~..~.
*~**^~~.^.*.~^**~*^^.*^*.^~~*~~~*^.#.#~~^*^#*^.^.*
.*^~..*~.*^^^^^~~^^*.~*.~~~.***~^.*##~~*****#~~^*.
.^^..^.^*^~^.~*...**~~~.**^*~~~*^*##~#*^~^~~^#^*.*
**.**~.**~.*.*^~~.~^.*^.~~*.^*.~.###~*#^..~*.~#^*^
~..^.****^.****~^~***..^^^^*^.~*####~~#^**^*~^*#~~
^*~^.~*...^^.^~.^^..~^...**...^####^#~#~*^..~^*~#~
...^~^.~^^~~~~.*^~.^~***~~^^^#####~##*~#~**^***^~#
.~~~~~^^.~~*^.~^^^**~^~.^~^~#####~######~^~**.*.^#
~^**.~**..*^~^^^.^*^~^~*^.~*~####*##.###~**^~~^~^X
